#########
#       #
#    P  #
#       #
#   X  O#
#########