#########
#       #
#    P  #
#        
#   X  O#
#########